AE	EMIRATOS ARABES	AS
AF	AFGANISTAN	AS
AG	ANTIGUA Y BARBUDA	AM
AI	ANGUILLA	AM
AK	ALASKA	AM
AL	ALBANIA	EU
AN	ANTILLAS HOLANDESAS	AM
AO	ANGOLA	AF
AR	ARGENTINA	AM
AT	AUSTRIA	EU
AU	AUSTRALIA	OC
BA	BIRMANIA	AS
BB	BARBADOS	AM
BD	BANGLADESH	AS
BE	BELGICA	EU
BF	BURQUINA FASO	AF
BG	BULGARIA	EU
BH	BAHRAIN	AS
BJ	BENIN	AF
BM	BERMUDA	AM
BO	BOLIVIA	AM
BR	BRASIL	AM
BS	BAHAMAS	AM
BU	BURMA	AS
BZ	BELICE	AM
BZ	BELIZE	AM
CA	CANADA	AM
CG	CONGO	AF
CI	COSTA DE MARFIL	AF
CL	CHILE	AM
CM	CAMERUN	AF
CN	CHINA	AS
CO	COLOMBIA	AM
CR	COSTA RICA	AM
CS	CHECOSLOVAQUIA	EU
CS	REPUBLICA CHECA	EU
CT	CROACIA	EU
CU	CUBA	AM
CV	CABO VERDE	AF
CY	CHIPRE	AS
CH	SUIZA	EU
DE	ALEMANIA	EU
DJ	DJIBOUTI	AF
DK	DINAMARCA	EU
DM	DOMINICA	AM
DO	REPUBLICA DOMINICANA	AM
DZ	ARGELIA	AF
EC	ECUADOR	AM
EG	EGIPTO	AF
EL	ESLOVENIA	EU
EN	ESTONIA	AS
EQ	GUINEA ECUATORIAL	AF
ES	ESPANA	EU
ET	ETIOPIA	AF
EV	ESLOVAQUIA	EU
FI	FINLANDIA	EU
FJ	FIDJI	OC
FJ	FIJI	OC
FR	FRANCIA	EU
GA	GABON	AF
GB	REINO UNIDO	EU
GD	GRENADA	AM
GF	GUYANA FRANCESA	AM
GH	GHANA	AF
GI	GIBRALTAR	EU
GL	GROENLANDIA	AM
GM	GAMBIA	AF
GN	GUINEA	AF
GP	GUADALUPE	AM
GQ	ISLA BU ANNOBON	AF
GR	GRECIA	EU
GT	GUATEMALA	AM
GW	GUINEA BISSAU	AF
GY	GUYANA	AM
HN	HONDURAS	AM
HT	HAITI	AM
HU	HUNGRIA	EU
ID	INDONESIA	OC
IE	IRLANDA	EU
IL	ISRAEL	AS
IN	INDIA	AS
IR	IRAN	AS
IS	ISLANDIA	EU
IT	ITALIA	EU
JM	JAMAICA	AM
JO	JORDANIA	AS
JP	JAPON	AS
KE	KENIA	AF
KH	KAMPUCHEA	AS
KN	SAINT KITTS NEVIS	AM
KP	KOREA DEL NORTE	AS
KR	KOREA	AS
KR	KOREA DEL SUR	AS
KW	KUWAIT	AS
KY	ISLAS CAIMAN	AM
LB	LIBANO	AS
LC	SANTA LUCIA	AM
LI	LITUANIA	EU
LK	SRI LANKA	AS
LR	LIBERIA	AF
LT	LETONIA O LATVIA	EU
LU	LUXEMBURGO	EU
LY	LIBIA	AF
MA	MARRUECOS	AF
MG	MADAGASCAR	AF
MO	MACAO	AS
MQ	MARTINICA	AM
MR	MAURITANIA	AF
MS	MONSERRAT	AS
MT	MALTA	EU
MW	MALAWI	AF
MX	MEXICO	AM
MY	MALASYA	AS
MZ	MOZAMBIQUE	AF
NC	NUEVA CALEDONIA	OC
NE	EMIRATOS ARABES	AS
NG	NIGERIA	AF
NI	NICARAGUA	AM
NL	HOLANDA	EU
NO	NORUEGA	EU
NP	NEPAL	AS
NZ	NUEVA ZELANDIA	OC
OM	OMAN	AS
PA	PANAMA	AM
PC	ISLAS DEL PACIFICO	OC
PE	PERU	AM
PF	POLINESIA	OC
PG	PAPUA NUEVA GUINEA	OC
PH	FILIPINAS	AS
PK	PAKISTAN	AS
PL	POLONIA	EU
PM	SAINT PIERRE MIQUEL	AM
PR	PUERTO RICO	AM
PT	PORTUGAL	EU
PY	PARAGUAY	AM
QA	QATAR	AS
RE	REUNION	AF
RO	RUMANIA	EU
SA	ARABIA SAUDITA	AS
SB	ISLAS SALOMON	AS
SB	ISLAS SOLOMON	OC
SD	SUDAN	AF
SE	SUECIA	EU
SG	SINGAPUR	AS
SH	SANTA HELENA	EU
SL	SIERRA LEONA	AF
SM	SAN MARINO	EU
SN	SENEGAL	AF
SR	SURINAM	AM
SU	RUSIA	EU
SV	EL SALVADOR	AM
SY	SIRIA	AS
TC	ISLAS TURKS Y CAICOS	AM
TG	TOGO	AF
TH	THAILANDIA	AS
TN	TUNEZ	AF
TR	TURQUIA	AS
TT	TRINIDAD Y TOBAGO	AM
TV	TUVALU	OC
TW	TAIWAN	AS
TZ	TANZANIA	AF
UC	UCRANIA	EU
US	ESTADOS UNIDOS	AM
UY	URUGUAY	AM
VC	SAN VICENTE	AM
VE	VENEZUELA	AM
VG	ISLAS VIRGENES GB	AM
VI	ISLAS VIRGENES US	AM
VN	VIETNAM	AS
VU	VANUATU	OC
XX	DESCONOCIDO	XX
YA	MYANMAR	AS
YD	YEMEN DEMOCRATICO	AS
YE	YEMEN	AS
YU	YUGOSLAVIA	EU
ZA	SUR AFRICA	AF
ZR	ZAIRE	AF
ZW	ZIMBAWE	AF
